NO (something.xpm, mettre les images ici )
SO 
WE 
EA 

F 143,169,89
C 161,200,244

// map there 
// mettre le player avec son orientation par ex:
111111
100101
101001
1100N1
111111