11111111111111111
10000010000000101
10100111000001111
10000000000000001
110001001000000N1
10000000000000001
10000000000000001
10000000000000001
11111111111111111