NO ./src/images/brick_wall.xpm
SO ./src/images/brick_wall.xpm
WE ./src/images/brick_wall.xpm
EA ./src/images/brick_wall.xpm

F 143,169,89
C 161,200,244

      1111111111111111111111111111
        100000000110000000001
        101100000111000000000001
        100100000000000000000001
111111111011000001110000000000001
100000000011000001110111111111111
1110111111111011100000010001
11111111111111011101010010001
1100000011010101110000001001
1111111111000000001100000010001
10000000000000001101010010001
1100000111010101111101111N00111
11110111 1110101 101111010001
11111111 1111111 111111111111