NO ./src/images/brick_wall.xpm
SO ./src/images/brick_wall.xpm
WE ./src/images/brick_wall.xpm
EA ./src/images/brick_wall.xpm

F 143,169,89
C 161,200,244

      1111111111111111111111111111
        10000000001100000000001
        1011000001110000000000001
        100100000000000000000001
111111111011000001110000000000001
100000000011000001110111111111111
11110111111111011100000010001
11110111111111011101010010001
11000000110101011100000010001
10000000000000001100000010001
1000000000000000110101001N001
1100000111010101111101111000111
11110111 1110101 101111010001
11111111 1111111 111111111111