11111111111111111
10000000000000101
10100111110001111
10111100010111001
110001011100000N1
10000001000010011
10001100011011001
10000111110001111
11111111111111111