1111111111
1000000001
1001011101
10111N0001
1111111111